aren't	are
isn't	is
wasn't	was
weren't	were
hasn't	has
haven't	have
hadn't	had
didn't	did
doesn't	does
don't	do
won't	will
can't	can
couldn't	could
wouldn't	would
mightn't	might
mustn't	must
needn't	need
oughtn't	ought
shan't	shall
shouldn't	should
mayn't	may
daren't	dare