stop	stopped
refer	referred
visit	visited
rob	robbed
sit	sat
begin	began
prefer	prefered
listen	listened
travel	traveled
burn	burnt
remain	remained
play	played
snow	snowed
carry	carried
marry	married
kiss	kissed
fix	fixed
go	went
have	had
be	was
be	were
see	saw
find	found
live	lived
talk	talked
study	studied
wait	waited
pay	paid
take	took