stop	stops
refer	refers
visit	visits
rob	robs
sit	sits
begin	begins
prefer	prefers
listen	listens
happen	happens
travel	travels
cancel	cancels
start	starts
burn	bruns
remain	remains
play	plays
snow	snows
carry	carries
marry	marries
kiss	kisses
fix	fixes
watch	watches
crash	crashes
go	goes